# *DO NOT DIRECTLY EDIT THIS FILE, IT IS AUTOMATICALLY GENERATED AND IT IS BASED ON:*
# https://docs.google.com/spreadsheet/ccc?key=0AmQEO36liL4FdDJLWVNMaVV2UmRKSnpXU09MYkdGbEE
aboutDrawio=關於 draw.io
access_denied=Access denied
actualSize=實際尺寸
add=Add
addLayer=新增圖層
addToExistingDrawing=Add to existing drawing
addWaypoint=Add waypoint
align=對齊
alignment=對齊
allChangesLost=All changes will be lost!
alreadyConnected=Nodes already connected
apply=Apply
arrange=排列
appNotInstalledAlert=App not installed. Please install draw.io in Chrome Web Store and try again.
appNotInstalledStatus=App not installed.
arrow=Arrow
arrows=Arrows
automatic=自動偵測(瀏覽器)
autosize=自動大小
background=背景圖層
backgroundColor=背景顏色
basic=Basic
blankDrawing=空白檔案
block=Block
bold=粗體
borderColor=邊長顏色
borderWidth=Borderwidth
bottom=下
bottomAlign=向下對齊
cancel=Cancel
center=水平置中
cannotLoad=Load attempts failed. Please try again later.
cannotLogin=Log in attempts failed. Please try again later.
changeOrientation=Change Orientation
chatJoined={1} has joined
chatLeft={1} has left
chatWindowTitle=Chat
circle=圓形排列
classic=Classic
clipart=Clipart
close=Close
collapse=Collapse
collapse-expand=Collapse/Expand
connect=連線
connecting=Connecting
connectWithDrive=連線至 Google Drive
connection=Connection
containsValidationErrors=Contains validation errors
copy=複製
copyConnect=Copy on connect
copyOfDrawing=製作副本
curved=曲線
custom=自訂
cut=剪下
dashed=虛線樣式
delete=刪除
diamond=Diamond
diamondThin=Diamond (Thin)
didYouKnow=Did you know...
direction=方向
done=Done
doubleClickOrientation=Doubleclick to change orientation
drawing=Drawing{1}
drawingEmpty=Drawing is empty
drawingTooLarge=Drawing is too large
duplicate=產生所選副本
east=向東漸層
edit=編輯
editLink=編輯超連結
embed=嵌入 HTML
embedNotice=Add this once at the end of the page
enterGroup=Enter group
enterValue=Enter value
enterName=Enter name
entityRelation=Entity Relation
error=Error
errorLoadingFile=Error loading file
errorRenamingFile=Error renaming file.
errorRenamingFileNotFound=Error renaming file. File was not found.
errorRenamingFileForbidden=Error renaming file. Insufficient access rights.
errorSavingFile=Error saving file
errorSavingFileForbidden=Error saving file. Insufficient access rights.
errorSavingFileNotFound=Error saving file. File was not found.
exitGroup=Exit Group
expand=Expand
export=輸出
failedToSaveTryReconnect=Failed to save, trying to reconnect
featureRequest=Feature Request
feedback=Feedback
file=檔案
filename=Filename
fileNotFound=File not found
fileNotLoaded=File not loaded
fileNotSaved=File not saved
fileOpenLocation=How would you like to open these file(s)?
fillColor=填滿顏色
fit=Fit
fitPage=填滿頁面
fitPageWidth=符合頁面寬度
fitWindow=填滿視窗
flipH=水平翻轉
flipV=垂直翻轉
fontColor=顏色
fontFamily=字型
fontSize=文字大小
format=格式
forum=Discussion/Help Forums
fromTemplate=從樣板開啟
fromText=From Text
general=通用
global=全域
gradient=漸層
gradientColor=顏色
grid=格線
group=組合
guides=參考線
hateApp=I hate draw.io
height=Height
help=說明
helpTranslate=Help us translate this application
hide=隱藏
hideIt=Hide {1}
hidden=Hidden
home=Home
horizontal=Horizontal
horizontalFlow=水平流線
horizontalTree=水平樹狀
image=Image
images=Images
inline=Inline
import=輸入
invalidOrMissingFile=Invalid or missing file
italic=斜體
layer=Layer
layers=圖層
landscape=Landscape
language=語言
restartForChangeRequired=Changes will take effect after page refresh.
layout=布局
left=左
leftAlign=向左對齊
line=邊線類別
lineend=邊線終點
linestart=邊線起點
linewidth=邊線寬度
loading=Loading
lockUnlock=鎖定/解鎖
loveApp=I love draw.io
manual=Manual
middle=垂直置中
moreResults=More Results
moreShapes=更多圖形
move=Move
moveSelectionTo=加入圖層 {1}
navigation=導航
new=新增
noColor=No color
noFiles=No files
noMoreResults=No More Results
none=None
noPlugins=No plugins
noResultsFor=No results for '{1}'
north=向北漸層
notConnected=Not connected
ok=OK
opacity=不透明度
open=開啟
openArrow=Open Arrow
openFile=Open file
openLink=開啟超連結
openInNewWindow=Open in new window
openSupported=Supported format is .XML files saved from this software
options=選項
organic=有機排列
orthogonal=Orthogonal
oval=Oval
pages=Pages
pageView=頁面檢視
pageSetup=頁面設置
pageScale=Page Scale
pan=Pan
paperSize=Paper Size
paste=貼上
perimeter=周長
plain=Plain
plugins=Plugins
pluginUrl=Plugin URL
pluginWarning=The page has requested to load the following plugin(s):\n \n {1}\n \n Would you like to load these plugin(s) now?\n \n NOTE : Only allow plugins to run if you fully understand the security implications of doing so.\n
position=位置
posterPrint=Poster Print
preferences=Preferences
preview=Preview
print=影印
readOnly=Read-only
reconnecting=Reconnecting
redo=重作
removeFromGroup=從組合刪除
removeIt=Remove {1}
removeWaypoint=Remove waypoint
rename=重新命名
renamed=Renamed
renameIt=Rename {1}
renaming=Renaming
replace={1} already exists. Do you want to replace it?
replaceExistingDrawing=Replace existing drawing
reset=Reset
resize=Resize
retryingIn=Retrying in {1} second(s)
retryingLoad=Load failed. Retrying...
retryingLogin=Login time out. Retrying...
right=右
rightAlign=向右對齊
rotate=Rotate
rotation=旋轉
rounded=圓角樣式
save=儲存
saveAs=另存新檔
saved=Saved
saving=Saving
scrollbars=頁面捲動
search=Search
selectAll=全選
selectEdges=選擇邊
selectFont=Select a font
selectVertices=選擇頂點
sendMessage=Send
sessionTimeoutOnSave=Your session has timed out and you have been disconnected from the Google Drive. Press OK to login and save. 
setAsDefaultEdge=設為預設邊
shadow=陰影
shape=Shape
shapes=Shapes
share=分享
shareLink=Link for shared editing
sharingServerNotice=Note: Experimental feature. Use at own risk!
sharingServerReady=Sharing server is ready.
sharingServerUnavailable=Sharing server is unavailable.
signOut=登出
size=Size
sourceSpacing=來源間距
south=向南漸層
spacing=間距
straight=Straight
strokeColor=邊線顏色
style=物件樣式
support=協助
targetSpacing=目標間距
text=文字
textAlignment=Text Alignment
textOpacity=文字不透明度
tilt=傾斜
toBack=向後移動
toFront=向前移動
tooltips=提示
top=上
topAlign=向上對齊
transparent=Transparent
underline=底線
undo=復原
ungroup=刪除組合
updatingDocument=Updating Document. Please wait...
updatingSelection=Updating Selection. Please wait...
url=URL
vertical=垂直翻轉
verticalFlow=垂直流線
verticalTree=垂直樹狀
view=檢視
west=向西漸層
width=Width
wordWrap=顯示文字超出範圍
zoom=Zoom
zoomIn=放大
zoomOut=縮小
